BBBBBBBBBBBBBBBBBBBBBBBBBBBBBBBBB
BPBBBBBBBBBBBBBBBBBBBBPPPPPPPPPPB
BPBBBBBBBBBBBBBBBBBBBBPBBBBBBBBBB
BPBBBBBBBBBBBBBBBBBBBBPBBBBBBBBBB
BPBBBBBBBBBBBBBBBBBBBBPBBBBBBBBBB
BPBBBBBBBBBBBBBBBBBBBBPBBBBBBBBBB
BPBBBBBBBBBBBBBBBBBBBBPBBBBBBBBBB
BPBBBBBBBBBBBBBBBBBBBBPBBBBBBBBBB
BPPPBBBBBBBBBBBBBBBBBBPBBBBBBBBBB
BBBPBBBBBBBBBBBBBBBBBBPBBBBBBBBBB
BBBPPPPPBBBBBBBBBBBBBBPBBBBBBBBBB
BBBBBBBPBBBBBBBBBBBBBBPBBBBBBBBBB
BBBBBBBPBBBBBBBBBBBBBBPBBBBBBBBBB
BBBBBBBPBBBBBBBBBBBBBBPBBBBBBBBBB
BBBBBBBPBBBBBBBBBBBBBBPBBBBBBBBBB
BBBBBBBPBBBBBBBBBBBBBBPBBBBBBBBBB
BBBBBBBPBBBBBBBBBBBBBBPBBBBBBBBBB
BBBBBBBPPPPPPPPPPPPPPPPBBBBBBBBBB
BBBBBBBBBBBBBBBBBBBBBBBBBBBBBBBBB